B.W.B.WBWWB.WB
.BB.BBBW..WBW.
WWW...B..W...B
....WW.BWW.BB.
..BWB..W..W.BW
W.B.BB..WBW..B
W.BBW..WB.BB.W
BWW.W.B.WW....
....BBWB.WBW..
W.B.WB.W.B...W
.B.B.WW.BB.BWB
...WB..BW.....
...W.B..WW.W.W
BWBBW...B..W.B