B.W.W.W.
BB.W...W
W..B..B.
.BW..W.B
...WB...
W.B..B.W
BWB..W.B
....B..W