BW..BB..W
W..B...B.
....W..W.
W.B..W..B
..W.W....
B........
..B...B.W
W...B....
B.W..W..B