..WWB.B.W.
W..W.....B
..B.W..B..
.......W..
B..W.B...W
B.W.......
B....W.B..
.B.WW....B
......B.WB
.WB.B.WB.W