.B.W...W.B.
WW..B.W....
....W.B..BW
...B.W....B
B......W...
W.B.......W
..B..W.B..B
.....B.....
.......B.W.
W..B......W
WB...W....B