W.BBWB...BW.
.......B....
....W....WB.
..W....W..B.
...W.B....W.
............
.W..B..W..BB
BB...W...B.W
W..B........
....B....W..
.W...B....WB
.B..W..B..WW