..BWW..B.W..
WB.W....B.WB
B..WB.WB.B.B
.B.WBW..W.BW
.W.WBWWBBW..
.BB..B......
WBW.W..BWBWB
B.WBBW.B.W..
....BWW..W..
WBWWW.B.BB.W
B.BWW.WW.B.W
.B.WBBBB..W.