W.W.B...BW....
BWW.BW.W.W..BW
WB..WBW..WWW.B
.B..BB.B...BWW
.WW....B.....B
B.BWB.BW..BBBB
W.W....B.BB.B.
..B...W..B...W
B.WB...W..W.W.
WB.B.....WW.WB
B.BWB..W.BB...
.WW.W...B.W.WB
W.B....WBB...B
..B.WWB..W.W.W