..B.W.BW..B.B.
WBW...W.B...W.
B.W.B.WBBW.BWW
.B.B.WBW.B.WB.
B.WB.W.W..BWW.
W.WBWB...W..BB
WWB.W...BBWBW.
.W.B.B.W...W.B
BW..BW.B..B...
..W.BWW.WB.WB.
.BB..B.W.B.B..
BWWBWB..BWBWW.
.BWW.WBWB.W.WB
BWB..W.B.WWB..